11111111111111111111111111
10000000000000000000000001
10000000000000000000000001
10000000000000000001110001
11111111110000000001000001
11111110000000000001000001
11111110000000000001000001
10000000000000000000000001
10000000000000000000000001
10001111111100000000000001
10000000000100000000110001
10000000000111111111100001
10000000000000000000100001
10000000000000000000111101
10000000000000000000000001
11111111111111111111111111